ItemName_EssencialR.CharcoalPowder = "炭粉",
MakeHay = "制作干草",
MakeAnimalFeedBag = "制作袋装动物饲料",
MakeGlue = "制作胶水",
MakeWoodGlue = "制作木胶",
RipNotebook = "撕碎笔记本",
MakeFishingHook = "制作鱼钩",
MakeFiberglassTape = "制作玻璃纤维胶带",
MakeTarp = "制作油布",
MakeNeedle = "制作针",
MakeBlackPaint = "制作黑色油漆",
MakeRedPaint = "制作红色油漆",
MakeBluePaint = "制作蓝色油漆",
MakeBrownPaint = "制作棕色油漆",
MakeCyanPaint = "制作青色油漆",
MakeGreenPaint = "制作绿色染料",
MakeGrayPaint = "制作灰色油漆",
MakeLightBluePaint = "制作浅蓝色油漆",
MakeLightBrownPaint = "制作浅棕色油漆",
MakeOrangePaint = "制作橙色油漆",
MakePinkPaint = "制作粉色染料",
MakePurplePaint = "制作紫色油漆",
MakeTurquoisePaint = "制作青绿色油漆",
MakeWhitePaint = "制作白色染料",
DisassembleWatch = "拆卸手表",
DismatleBulletproofVest = "拆卸防弹衣",
MakeDisinfectant = "制作消毒剂",
MakeAlcoholWipes = "制作酒精湿巾",
ExtractSugarBerries = "从浆果中提取糖",
GrindCandies = "研磨糖果中的糖",
MakeYeast = "从浆果中制作酵母",
MakeSugar = "制作糖",
MakeBakingSoda = "制作小苏打",
RecycleElectricWire = "回收电线",
MakeAluminium = "回收玻璃罐",
MakeVinegar = "制作醋",
MakeSalt = "制作盐",
MakeCleaningLiquid = "制作清洁液",
RipSLeatherItem = "撕碎小皮革物品",
MakeMop = "制作拖把",
MakeGunLight = "制作战术手电",
Makex2Scope = "制作2倍瞄准镜",
MakeAmmoStraps = "制作弹药带",
MakeTritiumSights = "制作氚瞄具",
DismantleToolBox = "拆卸工具箱",
MakeCarBatteryCharger = "制作汽车电池充电器",
MakeJack = "制作千斤顶",
MakeGenerator = "制作发电机",
MakeGeneratorPremium = "制作高级发电机",
MakeEngineParts = "制作备用发动机零件",
MakeWhetstone = "制作磨刀石",
BreakMirror = "打碎镜子",
MakeMotionSensor = "制作运动传感器",
MakeUnusableMetal = "制作废金属",
MakeWeldingRods = "制作焊条",
MakeCharcoalPowder = "制作炭粉",
MakeMatches = "制作火柴",
MakePeanutButter = "制作花生酱",