Recipe_Add_ChineseCigarette	/*_将中华香烟放入盒中_*/ = "Add Chinese Cigarette	/* 将中华香烟放入盒中 */",
Recipe_Add_FurongKing_Cigarette	/*_将芙蓉王香烟放入盒中_*/ = "Add Furong King Cigarette	/* 将芙蓉王香烟放入盒中 */",
Recipe_Add_Hetianxia_Cigarette	/*_将和天下香烟放入盒中_*/ = "Add Hetianxia Cigarette	/* 将和天下香烟放入盒中 */",
Recipe_Add_LiQunCigarette	/*_将利群香烟放入盒中_*/ = "Add Li Qun Cigarette	/* 将利群香烟放入盒中 */",
Recipe_Add_huanghelouCigarette	/*_将黄鹤楼香烟放入盒中_*/ = "Add huanghelou Cigarette	/* 将黄鹤楼香烟放入盒中 */",
Recipe_Add_yuxiCigarette	/*_将玉溪香烟放入盒中_*/ = "Add yuxi Cigarette	/* 将玉溪香烟放入盒中 */",
Recipe_CarvingChopsticks	/*_雕刻筷子x4_*/ = "Carving Chopsticks	/* 雕刻筷子x4 */",
Recipe_Carving_woodenskewers	/*_雕刻牙签串串x2_*/ = "Carving woodenskewers	/* 雕刻牙签串串x2 */",
Recipe_Chaoshan_Beef_Hotpot	/*_潮汕牛肉豪华火锅_*/ = "Chaoshan Beef Hotpot	/* 潮汕牛肉豪华火锅 */",
Recipe_Chaoshan_Hotpot_SoupBase	/*_潮汕火锅高汤_*/ = "Chaoshan Hotpot Soup Base	/* 潮汕火锅高汤 */",
Recipe_Collect_Hamimelon_seeds	/*_收集哈密瓜种子_*/ = "Collect Hamimelon seeds	/* 收集哈密瓜种子 */",
Recipe_Collect_fruittree_Seeds	/*_收集果树树苗_*/ = "Collect fruittree Seeds	/* 收集果树树苗 */",
Recipe_Collect_nectarine_kernel	/*_收集油桃果核_*/ = "Collect nectarine kernel	/* 收集油桃果核 */",
Recipe_Collect_qingzao_kernel	/*_收集青枣果核_*/ = "Collect qingzao kernel	/* 收集青枣果核 */",
Recipe_Collect_sanhuali_kernel	/*_收集三华李果核_*/ = "Collect sanhuali kernel	/* 收集三华李果核 */",
Recipe_Collect_shuimitao_kernel	/*_收集水蜜桃果核_*/ = "Collect shuimitao kernel	/* 收集水蜜桃果核 */",
Recipe_Cut_beef_into_minced_pieces	/*_切开牛肉为碎牛肉_*/ = "Cut beef into minced pieces	/* 切开牛肉为碎牛肉 */",
Recipe_Cut_ground_beef_into_small_pieces	/*_切开碎牛肉为小块碎牛肉_*/ = "Cut ground beef into small pieces	/* 切开碎牛肉为小块碎牛肉 */",
Recipe_Cut_pork_into_mincedpieces	/*_切开猪肉为碎猪肉_*/ = "Cut pork into mincedpieces	/* 切开猪肉为碎猪肉 */",
Recipe_Cutopen_beef_to_beef_slices	/*_切开牛肉获得肥牛卷_牛里脊肉_牛上脑_牛腱子肉_牛腩_‌西冷_*/ = "Cutopen beef to beef slices	/* 切开牛肉获得肥牛卷 牛里脊肉 牛上脑 牛腱子肉 牛腩 ‌西冷 */",
Recipe_Cutopen_coriander_into_smallpieces	/*_切开香菜为一小段香菜_*/ = "Cutopen coriander into smallpieces	/* 切开香菜为一小段香菜 */",
Recipe_Cutopen_ginger_into_ginger_slices	/*_切开生姜为生姜片_*/ = "Cutopen ginger into ginger slices	/* 切开生姜为生姜片 */",
Recipe_Cutopen_parsley_into_smallpieces	/*_切开欧芹为一小段欧芹_*/ = "Cutopen parsley into smallpieces	/* 切开欧芹为一小段欧芹 */",
Recipe_Cutopen_porkbelly_into_slices	/*_切开五花肉为切片_*/ = "Cutopen porkbelly into slices	/* 切开五花肉为切片 */",
Recipe_Cutopen_scallion_into_smallpieces	/*_切开香葱为一小段香葱_*/ = "Cutopen scallion into smallpieces	/* 切开香葱为一小段香葱 */",
Recipe_Cutopen_white_radish_into_slices	/*_切开白萝卜为片_*/ = "Cutopen white radish into slices	/* 切开白萝卜为片 */",
Recipe_Exchange_immortal_bean_saplings	/*_换取仙豆树苗_*/ = "Exchange immortal bean saplings	/* 换取仙豆树苗 */",
Recipe_Grilled_beef_skewers	/*_烤牛肉串_*/ = "Grilled beef skewers	/* 烤牛肉串 */",
Recipe_Making_redoil	/*_制作红油汤底_*/ = "Making redoil	/* 制作红油汤底 */",
Recipe_Making_steamer_molds	/*_制作蒸笼模具_*/ = "Making steamer molds	/* 制作蒸笼模具 */",
Recipe_Marinated_duck_meat	/*_制作腌制鸭肉_*/ = "Marinated duck meat	/* 制作腌制鸭肉 */",
Recipe_Marinated_pork_belly	/*_腌制五花肉_*/ = "Marinated pork belly	/* 腌制五花肉 */",
Recipe_Open_AAAwallet	/*_打开建材王总的钱包_*/ = "Open AA Awallet	/* 打开建材王总的钱包 */",
Recipe_Open_Bagged_Sunflower_seed	/*_打开袋装月牙香瓜子_*/ = "Open Bagged Sunflower seed	/* 打开袋装月牙香瓜子 */",
Recipe_Open_Bagged_Weilong_spicystrips	/*_打开袋装卫龙大刀肉辣条_*/ = "Open Bagged Weilong spicystrips	/* 打开袋装卫龙大刀肉辣条 */",
Recipe_Open_Bottle_Beer	/*_打开一瓶瓶装啤酒_*/ = "Open Bottle Beer	/* 打开一瓶瓶装啤酒 */",
Recipe_Open_Bottle_baijiu	/*_打开一瓶瓶装白酒_*/ = "Open Bottle baijiu	/* 打开一瓶瓶装白酒 */",
Recipe_Open_Budweiser_bottle_Pack	/*_打开一打百威啤酒_瓶装_*/ = "Open Budweiser bottle Pack	/* 打开一打百威啤酒 瓶装 */",
Recipe_Open_Budweiser_can_Pack	/*_打开一打百威啤酒_罐装_*/ = "Open Budweiser can Pack	/* 打开一打百威啤酒 罐装 */",
Recipe_Open_Canned_fairybeans	/*_打开罐装七龙珠仙豆_*/ = "Open Canned fairybeans	/* 打开罐装七龙珠仙豆 */",
Recipe_Open_Chinese_Blindbox	/*_打开_盲盒包_*/ = "Open Chinese Blindbox	/* 打开 盲盒包 */",
Recipe_Open_HarbinBeer_bottle_Pack	/*_打开一打哈尔滨啤酒_瓶装_*/ = "Open Harbin Beer bottle Pack	/* 打开一打哈尔滨啤酒 瓶装 */",
Recipe_Open_HarbinBeer_can_Pack	/*_打开一打哈尔滨啤酒_罐装_*/ = "Open Harbin Beer can Pack	/* 打开一打哈尔滨啤酒 罐装 */",
Recipe_Open_Nut_GiftPack	/*_打开坚果大礼包_*/ = "Open Nut Gift Pack	/* 打开坚果大礼包 */",
Recipe_Open_Snow_canbeer_Pack	/*_打开一打雪花啤酒_罐装_*/ = "Open Snow canbeer Pack	/* 打开一打雪花啤酒 罐装 */",
Recipe_Open_Snowbeer_bottle_Pack	/*_打开一打雪花啤酒_瓶装_*/ = "Open Snowbeer bottle Pack	/* 打开一打雪花啤酒 瓶装 */",
Recipe_Open_Tang_Daren	/*_冲泡一桶汤达人日式豚骨面_*/ = "Open Tang Daren	/* 冲泡一桶汤达人日式豚骨面 */",
Recipe_Open_Tsingtao_canBeer_Pack	/*_打开一打青岛啤酒_罐装_*/ = "Open Tsingtao can Beer Pack	/* 打开一打青岛啤酒 罐装 */",
Recipe_Open_Tsingtaobeer_bottle_Pack	/*_打开一打青岛啤酒_瓶装_*/ = "Open Tsingtaobeer bottle Pack	/* 打开一打青岛啤酒 瓶装 */",
Recipe_Open_bagged_betelnut	/*_打开袋装口味王槟榔_*/ = "Open bagged betelnut	/* 打开袋装口味王槟榔 */",
Recipe_Open_baixiang_chickennoodle	/*_冲泡一桶白象老母鸡汤面_*/ = "Open baixiang chickennoodle	/* 冲泡一桶白象老母鸡汤面 */",
Recipe_Open_basket_of_ginger	/*_打开一筐生姜_*/ = "Open basket of ginger	/* 打开一筐生姜 */",
Recipe_Open_box_of_Chinese_cigarettes	/*_打开一盒中华香烟_*/ = "Open box of Chinese cigarettes	/* 打开一盒中华香烟 */",
Recipe_Open_box_of_FurongKing_Cigarette	/*_打开一盒芙蓉王香烟_*/ = "Open box of Furong King Cigarette	/* 打开一盒芙蓉王香烟 */",
Recipe_Open_box_of_Hetianxia_Cigarette	/*_打开一盒和天下香烟_*/ = "Open box of Hetianxia Cigarette	/* 打开一盒和天下香烟 */",
Recipe_Open_box_of_LiQun_cigarettes	/*_打开一盒利群香烟_*/ = "Open box of Li Qun cigarettes	/* 打开一盒利群香烟 */",
Recipe_Open_box_of_huanghelou_cigarettes	/*_打开一盒黄鹤楼香烟_*/ = "Open box of huanghelou cigarettes	/* 打开一盒黄鹤楼香烟 */",
Recipe_Open_box_of_yuxi_cigarettes	/*_打开一盒玉溪香烟_*/ = "Open box of yuxi cigarettes	/* 打开一盒玉溪香烟 */",
Recipe_Open_ksfhsnrm	/*_冲泡一桶康师傅红烧牛肉面_*/ = "Open ksfhsnrm	/* 冲泡一桶康师傅红烧牛肉面 */",
Recipe_Open_ksfltscnrm	/*_冲泡一桶康师傅老坛酸菜牛肉面_*/ = "Open ksfltscnrm	/* 冲泡一桶康师傅老坛酸菜牛肉面 */",
Recipe_Open_ksfxlnrm	/*_冲泡一桶康师傅香辣牛肉面_*/ = "Open ksfxlnrm	/* 冲泡一桶康师傅香辣牛肉面 */",
Recipe_Open_packaging_of_corn_hamsausage	/*_打开包装玉米火腿肠_*/ = "Open packaging of corn hamsausage	/* 打开包装玉米火腿肠 */",
Recipe_Open_packaging_of_shuanghui_hamsausage	/*_打开包装双汇火腿肠_*/ = "Open packaging of shuanghui hamsausage	/* 打开包装双汇火腿肠 */",
Recipe_Pack_ChineseCigarette_Carton	/*_将中华香烟盒装打包为条装_*/ = "Pack Chinese Cigarette Carton	/* 将中华香烟盒装打包为条装 */",
Recipe_Pack_Chinese_cigarettes_into_boxes	/*_将中华香烟打包为盒装_*/ = "Pack Chinese cigarettes into boxes	/* 将中华香烟打包为盒装 */",
Recipe_Pack_FurongKing_CigaretteCarton	/*_将芙蓉王香烟盒装打包为条装_*/ = "Pack Furong King_Cigarette Carton	/* 将芙蓉王香烟盒装打包为条装 */",
Recipe_Pack_FurongKing_Cigarette_into_boxes	/*_将芙蓉王香烟打包为盒装_*/ = "Pack Furong King Cigarette into boxes	/* 将芙蓉王香烟打包为盒装 */",
Recipe_Pack_Hetianxia_CigaretteCarton	/*_将和天下香烟盒装打包为条装_*/ = "Pack Hetianxia_Cigarette Carton	/* 将和天下香烟盒装打包为条装 */",
Recipe_Pack_Hetianxia_Cigarette_into_boxes	/*_将和天下香烟打包为盒装_*/ = "Pack Hetianxia Cigarette into boxes	/* 将和天下香烟打包为盒装 */",
Recipe_Pack_LiQunCigarette_Carton	/*_将利群香烟盒装打包为条装_*/ = "Pack Li Qun Cigarette Carton	/* 将利群香烟盒装打包为条装 */",
Recipe_Pack_Liqun_cigarettes_into_boxes	/*_将利群香烟打包为盒装_*/ = "Pack Liqun cigarettes into boxes	/* 将利群香烟打包为盒装 */",
Recipe_Pack_Yellow_Crane_Tower_cigarettes_into_boxes	/*_将黄鹤楼香烟打包为盒装_*/ = "Pack Yellow Crane Tower cigarettes into boxes	/* 将黄鹤楼香烟打包为盒装 */",
Recipe_Pack_Yuxi_cigarettes_into_boxes	/*_将玉溪香烟打包为盒装_*/ = "Pack Yuxi cigarettes into boxes	/* 将玉溪香烟打包为盒装 */",
Recipe_Pack_huanghelouCigarette_Carton	/*_将黄鹤楼香烟盒装打包为条装_*/ = "Pack huanghelou Cigarette Carton	/* 将黄鹤楼香烟盒装打包为条装 */",
Recipe_Pack_yuxiCigarette_Carton	/*_将玉溪香烟盒装打包为条装_*/ = "Pack yuxi Cigarette Carton	/* 将玉溪香烟盒装打包为条装 */",
Recipe_Peelopen_sweet_grapefruit	/*_剥开甜柚果实_*/ = "Peelopen sweet grapefruit	/* 剥开甜柚果实 */",
Recipe_PoachedChicken	/*_制作白切鸡_*/ = "Poached Chicken	/* 制作白切鸡 */",
Recipe_Put_10cinnamon_back_into_bag	/*_10个桂皮打包成一捆桂皮_*/ = "Put 10cinnamon back into bag	/* 10个桂皮打包成一捆桂皮 */",
Recipe_Put_10staranise_back_into_bag	/*_10个八角茴香打包成一袋装八角茴香_*/ = "Put 10staranise back into bag	/* 10个八角茴香打包成一袋装八角茴香 */",
Recipe_Put_30GojiBerry_back_into_bag	/*_30个枸杞打包成一袋枸杞_*/ = "Put 30 Goji Berry back into bag	/* 30个枸杞打包成一袋枸杞 */",
Recipe_Put_30bayleaf_back_into_bag	/*_30个香叶打包成一袋香叶_*/ = "Put 30bayleaf back into bag	/* 30个香叶打包成一袋香叶 */",
Recipe_Put_30jujube_back_into_bag	/*_30个红枣打包成一袋红枣_*/ = "Put 30jujube back into bag	/* 30个红枣打包成一袋红枣 */",
Recipe_Salted_Duck	/*_制作盐水鸭_*/ = "Salted Duck	/* 制作盐水鸭 */",
Recipe_Scrambled_egg_with_tomato	/*_制作番茄炒蛋_*/ = "Scrambled egg with tomato	/* 制作番茄炒蛋 */",
Recipe_Sichuan_spicy_hotpot	/*_制作川味麻辣火锅_*/ = "Sichuan spicy hotpot	/* 制作川味麻辣火锅 */",
Recipe_Stewed_Braised_pork_belly	/*_炖煮香喷喷的红烧肉_*/ = "Stewed Braised pork belly	/* 炖煮香喷喷的红烧肉 */",
Recipe_Stir_fried_sugar_colored_pork_belly	/*_制作炒糖色的五花肉块_*/ = "Stir fried sugar colored pork belly	/* 制作炒糖色的五花肉块 */",
Recipe_Stirfried_Broccoli	/*_制作清炒西兰花_*/ = "Stirfried Broccoli	/* 制作清炒西兰花 */",
Recipe_Stoneground_egg_pork_sausagepowder	/*_制作石磨肠粉肉蛋肠_*/ = "Stoneground egg pork sausagepowder	/* 制作石磨肠粉肉蛋肠 */",
Recipe_Stoneground_egg_sausagepowder	/*_制作石磨肠粉蛋肠_*/ = "Stoneground egg sausagepowder	/* 制作石磨肠粉蛋肠 */",
Recipe_Stoneground_ham_sausagepowder	/*_制作石磨肠粉火腿肠_*/ = "Stoneground ham sausagepowder	/* 制作石磨肠粉火腿肠 */",
Recipe_Stoneground_pork_sausagepowder	/*_制作石磨肠粉肉肠_*/ = "Stoneground pork sausagepowder	/* 制作石磨肠粉肉肠 */",
Recipe_Take_ChineseCigarette	/*_拿一根中华香烟_*/ = "Take Chinese Cigarette	/* 拿一根中华香烟 */",
Recipe_Take_FurongKing_Cigarette	/*_拿一根芙蓉王香烟_*/ = "Take Furong King Cigarette	/* 拿一根芙蓉王香烟 */",
Recipe_Take_Hetianxia_Cigarette	/*_拿一根和天下香烟_*/ = "Take Hetianxia Cigarette	/* 拿一根和天下香烟 */",
Recipe_Take_LiQunCigarette	/*_拿一根利群香烟_*/ = "Take Li Qun Cigarette	/* 拿一根利群香烟 */",
Recipe_Take_huanghelouCigarette	/*_拿一根黄鹤楼香烟_*/ = "Take huanghelou Cigarette	/* 拿一根黄鹤楼香烟 */",
Recipe_Take_yuxiCigarette	/*_拿一根玉溪香烟_*/ = "Take yuxi Cigarette	/* 拿一根玉溪香烟 */",
Recipe_Unpack_Chinese_CigaretteCarton	/*_打开条装中华香烟_*/ = "Unpack Chinese Cigarette Carton	/* 打开条装中华香烟 */",
Recipe_Unpack_LiQun_CigaretteCarton	/*_打开条装利群香烟_*/ = "Unpack Li Qun Cigarette Carton	/* 打开条装利群香烟 */",
Recipe_Unpack_huanghelou_CigaretteCarton	/*_打开条装黄鹤楼香烟_*/ = "Unpack huanghelou Cigarette Carton	/* 打开条装黄鹤楼香烟 */",
Recipe_Unpack_yuxi_CigaretteCarton	/*_打开条装玉溪香烟_*/ = "Unpack yuxi Cigarette Carton	/* 打开条装玉溪香烟 */",
Recipe_WestLakeFish_balsamic_vinegar_/*_制作西湖醋鱼的醋汁_*/ = "West Lake Fish balsamic vinegar /* 制作西湖醋鱼的醋汁 */",
Recipe_WestLakeFish_inVinegar	/*_制作西湖醋鱼_*/ = "West Lake Fish in Vinegar	/* 制作西湖醋鱼 */",
Recipe_chunks_Durian	/*_榴莲切块_*/ = "chunks Durian	/* 榴莲切块 */",
Recipe_chunks_Hamimelon	/*_哈密瓜切块_*/ = "chunks Hamimelon	/* 哈密瓜切块 */",
Recipe_open_Bagged_GojiBerry	/*_打开一袋装枸杞_*/ = "open Bagged Goji Berry	/* 打开一袋装枸杞 */",
Recipe_open_Bagged_staranise	/*_打开一袋装八角茴香_*/ = "open Bagged staranise	/* 打开一袋装八角茴香 */",
Recipe_open_FurongKing_CigaretteCarton	/*_打开条装芙蓉王香烟_*/ = "open Furong King Cigarette Carton	/* 打开条装芙蓉王香烟 */",
Recipe_open_HamiMelon_BagSeed	/*_打开哈密瓜种子包_*/ = "open Hami Melon Bag Seed	/* 打开哈密瓜种子包 */",
Recipe_open_Hetianxia_CigaretteCarton	/*_打开条装和天下香烟_*/ = "open Hetianxia Cigarette Carton	/* 打开条装和天下香烟 */",
Recipe_open_bagged_jujube	/*_打开一袋装红枣_*/ = "open bagged jujube	/* 打开一袋装红枣 */",
Recipe_open_bundle_cinnamon	/*_打开一捆桂皮_*/ = "open bundle cinnamon	/* 打开一捆桂皮 */",
Recipe_open_kiwifruit_BagSeed	/*_打开猕猴桃种子包_*/ = "open kiwifruit Bag Seed	/* 打开猕猴桃种子包 */",
Recipe_open_package_bayleaf	/*_打开一大盘香叶_*/ = "open package bayleaf	/* 打开一大盘香叶 */",
Recipe_saute_leek_sproutseggs	/*_制作韭菜炒蛋_*/ = "saute leek sproutseggs	/* 制作韭菜炒蛋 */",
Recipe_seedsback_into_seedpack	/*_将种子装回种子包里_*/ = "seedsback into seedpack	/* 将种子装回种子包里 */",
Recipe_steamedpork_with_riceflour	/*_制作粉蒸肉_*/ = "steamedpork with riceflour	/* 制作粉蒸肉 */",